834,472,838,305,255,255,22,255
838,305,844,83,255,255,22,255
844,83,962,85,255,255,22,255
962,85,963,218,255,255,22,255
963,218,997,285,255,255,22,255
997,285,1148,298,255,255,22,255
1148,298,1231,264,255,255,22,255
1231,264,1332,200,255,255,22,255
1332,200,1345,135,255,255,22,255
1345,135,1355,23,255,255,22,255
1355,23,1322,-73,255,255,22,255
1322,-73,1283,-165,255,255,22,255
1283,-165,1186,-190,255,255,22,255
1186,-190,1354,-209,255,255,22,255
1354,-209,1434,-105,255,255,22,255
1434,-105,1446,-2,255,255,22,255
1446,-2,1544,51,255,255,22,255
1544,51,1685,43,255,255,22,255
1685,43,1777,-23,255,255,22,255
1777,-23,1803,-128,255,255,22,255
1803,-128,1813,-211,255,255,22,255
1813,-211,1803,-281,255,255,22,255
1803,-281,1885,-222,255,255,22,255
1885,-222,1955,-58,255,255,22,255
1955,-58,1904,65,255,255,22,255
1904,65,1849,133,255,255,22,255
1849,133,1719,243,255,255,22,255
1719,243,1725,291,255,255,22,255
1725,291,1787,333,255,255,22,255
1787,333,1785,364,255,255,22,255
1785,364,1783,381,255,255,22,255
1783,381,1754,410,255,255,22,255
1754,410,1715,429,255,255,22,255
1715,429,1666,435,255,255,22,255
1666,435,1641,437,255,255,22,255
1641,437,1475,502,255,255,22,255
1475,502,1428,508,255,255,22,255
1428,508,1374,512,255,255,22,255
1374,512,1302,510,255,255,22,255
1302,510,1195,518,255,255,22,255
1195,518,1137,527,255,255,22,255
1137,527,1080,539,255,255,22,255
1080,539,1031,545,255,255,22,255
1031,545,833,473,255,255,22,255
736,474,754,-31,255,255,22,255
754,-31,1073,-24,255,255,22,255
1073,-24,1069,164,255,255,22,255
1069,164,1083,190,255,255,22,255
1083,190,1153,169,255,255,22,255
1153,169,1216,106,255,255,22,255
1216,106,1211,30,255,255,22,255
1211,30,1185,-28,255,255,22,255
1185,-28,1146,-70,255,255,22,255
1146,-70,1054,-98,255,255,22,255
1054,-98,990,-114,255,255,22,255
990,-114,981,-170,255,255,22,255
981,-170,983,-218,255,255,22,255
983,-218,1028,-255,255,255,22,255
1028,-255,1099,-278,255,255,22,255
1099,-278,1164,-288,255,255,22,255
1164,-288,1401,-311,255,255,22,255
1401,-311,1463,-271,255,255,22,255
1463,-271,1533,-232,255,255,22,255
1533,-232,1511,-174,255,255,22,255
1467,-267,1515,-167,255,255,22,255
1515,-167,1550,-126,255,255,22,255
1550,-126,1549,-72,255,255,22,255
1549,-72,1553,-42,255,255,22,255
1553,-42,1595,-26,255,255,22,255
1595,-26,1636,-34,255,255,22,255
1636,-34,1680,-57,255,255,22,255
1680,-57,1700,-91,255,255,22,255
1700,-91,1718,-149,255,255,22,255
1718,-149,1725,-356,255,255,22,255
1725,-356,1726,-381,255,255,22,255
1726,-381,1787,-374,255,255,22,255
1787,-374,1846,-361,255,255,22,255
1846,-361,1898,-325,255,255,22,255
1898,-325,1949,-277,255,255,22,255
1949,-277,2037,-136,255,255,22,255
2037,-136,2059,-93,255,255,22,255
2059,-93,2041,47,255,255,22,255
2041,47,1937,185,255,255,22,255
1937,185,1873,223,255,255,22,255
1873,223,1820,250,255,255,22,255
1820,250,1840,285,255,255,22,255
1840,285,1869,313,255,255,22,255
1869,313,1837,454,255,255,22,255
1837,454,1763,495,255,255,22,255
1763,495,1642,505,255,255,22,255
1642,505,1682,626,255,255,22,255
1682,626,1748,699,255,255,22,255
1748,699,1754,777,255,255,22,255
1754,777,1711,800,255,255,22,255
1711,800,1651,803,255,255,22,255
1651,803,1592,799,255,255,22,255
1592,799,1556,784,255,255,22,255
1556,784,1523,760,255,255,22,255
1523,760,1499,737,255,255,22,255
1499,737,1475,706,255,255,22,255
1475,706,1459,677,255,255,22,255
1459,677,1443,640,255,255,22,255
1443,640,1431,611,255,255,22,255
1431,611,1417,588,255,255,22,255
1417,588,1070,611,255,255,22,255
1070,611,905,608,255,255,22,255
905,608,829,569,255,255,22,255
829,569,742,499,255,255,22,255
742,499,839,477,255,255,22,255
736,476,740,497,255,255,22,255
1474,504,1496,568,255,255,22,255
1496,568,1535,625,255,255,22,255
1535,625,1541,561,255,255,22,255
1541,561,1518,488,255,255,22,255
1662,572,1666,630,255,255,22,255
1666,630,1658,676,255,255,22,255
1658,676,1628,727,255,255,22,255
1628,727,1580,746,255,255,22,255
1580,746,1528,754,255,255,22,255
1528,754,1503,744,255,255,22,255
1660,560,1662,586,255,255,22,255
