821,472,781,474,255,255,22,255
781,474,782,434,255,255,22,255
820,473,820,436,255,255,22,255
821,434,870,303,255,255,22,255
870,303,904,263,255,255,22,255
904,263,929,250,255,255,22,255
929,250,983,245,255,255,22,255
983,245,1020,250,255,255,22,255
1020,250,1053,274,255,255,22,255
1053,274,1054,307,255,255,22,255
1054,307,1062,373,255,255,22,255
1062,373,1041,412,255,255,22,255
1041,412,989,470,255,255,22,255
989,470,895,500,255,255,22,255
895,500,791,510,255,255,22,255
791,510,719,495,255,255,22,255
783,432,777,390,255,255,22,255
777,390,777,344,255,255,22,255
777,344,782,301,255,255,22,255
782,301,793,261,255,255,22,255
793,261,822,223,255,255,22,255
822,223,863,183,255,255,22,255
863,183,894,164,255,255,22,255
894,164,940,149,255,255,22,255
940,149,982,142,255,255,22,255
982,142,1027,141,255,255,22,255
1027,141,1069,149,255,255,22,255
1069,149,1095,164,255,255,22,255
1095,164,1125,206,255,255,22,255
1125,206,1145,251,255,255,22,255
1145,251,1153,294,255,255,22,255
1153,294,1153,350,255,255,22,255
1153,350,1149,385,255,255,22,255
1149,385,1140,411,255,255,22,255
1140,411,1127,437,255,255,22,255
1127,437,1097,482,255,255,22,255
1097,482,1050,519,255,255,22,255
1050,519,1023,538,255,255,22,255
1023,538,980,562,255,255,22,255
980,562,962,574,255,255,22,255
962,574,947,584,255,255,22,255
947,584,912,595,255,255,22,255
912,595,882,603,255,255,22,255
882,603,852,616,255,255,22,255
852,616,828,632,255,255,22,255
828,632,804,643,255,255,22,255
804,643,760,659,255,255,22,255
760,659,731,664,255,255,22,255
731,664,710,656,255,255,22,255
710,656,696,643,255,255,22,255
696,643,688,625,255,255,22,255
688,625,673,607,255,255,22,255
673,607,665,591,255,255,22,255
665,591,653,577,255,255,22,255
653,577,643,568,255,255,22,255
643,568,629,560,255,255,22,255
629,560,621,552,255,255,22,255
621,552,603,540,255,255,22,255
603,540,589,525,255,255,22,255
589,525,574,507,255,255,22,255
574,507,561,491,255,255,22,255
561,491,535,466,255,255,22,255
535,466,519,446,255,255,22,255
519,446,493,425,255,255,22,255
493,425,420,387,255,255,22,255
420,387,374,371,255,255,22,255
374,371,330,360,255,255,22,255
330,360,274,352,255,255,22,255
274,352,231,349,255,255,22,255
231,349,184,350,255,255,22,255
184,350,146,357,255,255,22,255
146,357,109,366,255,255,22,255
719,494,526,334,255,255,22,255
526,334,346,267,255,255,22,255
346,267,222,248,255,255,22,255
222,248,124,260,255,255,22,255
124,260,32,271,255,255,22,255
32,271,11,145,255,255,22,255
11,145,-7,6,255,255,22,255
115,365,-44,387,255,255,22,255
-44,387,-77,224,255,255,22,255
-77,224,-98,102,255,255,22,255
-98,102,-175,112,255,255,22,255
-175,112,-162,215,255,255,22,255
-162,215,-157,274,255,255,22,255
-8,5,-182,38,255,255,22,255
-182,38,-259,49,255,255,22,255
-259,49,-251,168,255,255,22,255
-251,168,-246,277,255,255,22,255
-158,264,-134,590,255,255,22,255
-245,278,-234,491,255,255,22,255
-234,491,-221,599,255,255,22,255
-221,599,-216,640,255,255,22,255
-216,640,-196,680,255,255,22,255
-196,680,-151,710,255,255,22,255
-151,710,-102,709,255,255,22,255
-102,709,-79,682,255,255,22,255
-79,682,-70,638,255,255,22,255
-70,638,-64,589,255,255,22,255
-64,589,-66,569,255,255,22,255
-144,404,-38,387,255,255,22,255
-66,571,-70,505,255,255,22,255
-70,505,-70,476,255,255,22,255
-70,476,-13,468,255,255,22,255
-13,468,47,467,255,255,22,255
47,467,101,472,255,255,22,255
101,472,152,466,255,255,22,255
152,466,205,462,255,255,22,255
205,462,250,469,255,255,22,255
250,469,283,515,255,255,22,255
283,515,277,600,255,255,22,255
277,600,198,650,255,255,22,255
198,650,135,680,255,255,22,255
135,680,119,732,255,255,22,255
119,732,151,786,255,255,22,255
151,786,208,808,255,255,22,255
208,808,318,918,255,255,22,255
318,918,372,932,255,255,22,255
372,932,388,951,255,255,22,255
388,951,435,959,255,255,22,255
435,959,464,956,255,255,22,255
464,956,485,924,255,255,22,255
485,924,502,871,255,255,22,255
502,871,516,839,255,255,22,255
516,839,562,805,255,255,22,255
562,805,585,796,255,255,22,255
585,796,622,790,255,255,22,255
622,790,646,777,255,255,22,255
646,777,665,742,255,255,22,255
665,742,680,714,255,255,22,255
680,714,699,700,255,255,22,255
701,700,798,734,255,255,22,255
798,734,939,743,255,255,22,255
939,743,1045,745,255,255,22,255
1045,745,1178,757,255,255,22,255
1178,757,1240,762,255,255,22,255
1240,762,1303,770,255,255,22,255
1303,770,1363,755,255,255,22,255
1363,755,1464,767,255,255,22,255
1464,767,1478,601,255,255,22,255
1478,601,1481,545,255,255,22,255
1481,545,1419,537,255,255,22,255
1419,537,1412,649,255,255,22,255
1412,649,1407,698,255,255,22,255
1407,698,1337,702,255,255,22,255
1337,702,1255,694,255,255,22,255
1255,694,1177,693,255,255,22,255
1177,693,1092,696,255,255,22,255
1092,696,1013,696,255,255,22,255
1013,696,929,696,255,255,22,255
929,696,885,693,255,255,22,255
885,693,830,684,255,255,22,255
830,684,783,677,255,255,22,255
783,677,753,672,255,255,22,255
753,672,728,664,255,255,22,255
1364,348,1357,479,255,255,22,255
1357,479,1480,477,255,255,22,255
1361,416,1437,416,255,255,22,255
1361,349,1494,348,255,255,22,255
1538,481,1552,344,255,255,22,255
1552,344,1605,494,255,255,22,255
1605,494,1618,340,255,255,22,255
1682,345,1682,502,255,255,22,255
1682,502,1745,493,255,255,22,255
1745,493,1760,480,255,255,22,255
1760,480,1774,456,255,255,22,255
1774,456,1782,421,255,255,22,255
1782,421,1780,389,255,255,22,255
1780,389,1756,367,255,255,22,255
1756,367,1718,350,255,255,22,255
1718,350,1695,348,255,255,22,255
1695,348,1682,345,255,255,22,255
1704,385,1704,472,255,255,22,255
1704,472,1723,469,255,255,22,255
1723,469,1732,459,255,255,22,255
1732,459,1741,440,255,255,22,255
1741,440,1745,414,255,255,22,255
1745,414,1740,399,255,255,22,255
1740,399,1703,382,255,255,22,255
