752,475,745,358,255,111,66,255
745,358,747,148,255,111,66,255
747,148,780,68,255,111,66,255
780,68,841,5,255,111,66,255
841,5,924,-53,255,111,66,255
924,-53,1009,-79,255,111,66,255
1009,-79,1128,-89,255,111,66,255
1128,-89,1219,-74,255,111,66,255
1219,-74,1262,-35,255,111,66,255
1262,-35,1292,44,255,111,66,255
1292,44,1321,124,255,111,66,255
1321,124,1415,146,255,111,66,255
1415,146,1486,95,255,111,66,255
1486,95,1511,5,255,111,66,255
1511,5,1486,-257,255,111,66,255
1486,-257,1438,-299,255,111,66,255
1438,-299,1355,-311,255,111,66,255
1355,-311,1287,-284,255,111,66,255
1287,-284,1238,-223,255,111,66,255
1238,-223,1188,-146,255,111,66,255
1188,-146,1143,-114,255,111,66,255
1143,-114,1087,-114,255,111,66,255
1087,-114,1023,-141,255,111,66,255
1023,-141,976,-190,255,111,66,255
976,-190,967,-250,255,111,66,255
967,-250,963,-302,255,111,66,255
963,-302,960,-353,255,111,66,255
960,-353,959,-453,255,111,66,255
959,-453,955,-508,255,111,66,255
955,-508,955,-558,255,111,66,255
955,-558,955,-608,255,111,66,255
955,-608,955,-758,255,111,66,255
955,-758,954,-858,255,111,66,255
954,-858,954,-908,255,111,66,255
954,-908,954,-958,255,111,66,255
954,-958,954,-1008,255,111,66,255
954,-1008,995,-1049,255,111,66,255
995,-1049,1063,-1058,255,111,66,255
1063,-1058,1147,-1045,255,111,66,255
1147,-1045,1190,-1007,255,111,66,255
1190,-1007,1303,-879,255,111,66,255
1303,-879,1403,-779,255,111,66,255
1403,-779,1553,-678,255,111,66,255
1553,-678,1606,-621,255,111,66,255
1606,-621,1661,-544,255,111,66,255
1661,-544,1686,-496,255,111,66,255
1686,-496,1763,-416,255,111,66,255
1763,-416,1844,-347,255,111,66,255
1844,-347,2117,-79,255,111,66,255
2117,-79,2275,72,255,111,66,255
2275,72,2249,93,255,111,66,255
2249,93,1532,-500,255,111,66,255
1532,-500,1482,-608,255,111,66,255
1482,-608,1422,-658,255,111,66,255
1422,-658,1337,-705,255,111,66,255
1337,-705,1246,-802,255,111,66,255
1246,-802,1142,-951,255,111,66,255
1142,-951,1089,-985,255,111,66,255
1089,-985,1042,-982,255,111,66,255
1042,-982,1019,-959,255,111,66,255
1019,-959,1015,-854,255,111,66,255
1015,-854,1023,-775,255,111,66,255
1023,-775,1036,-605,255,111,66,255
1036,-605,1057,-362,255,111,66,255
1057,-362,1079,-263,255,111,66,255
1079,-263,1122,-243,255,111,66,255
1122,-243,1146,-251,255,111,66,255
1146,-251,1255,-405,255,111,66,255
1255,-405,1309,-447,255,111,66,255
1309,-447,1423,-446,255,111,66,255
1423,-446,1497,-428,255,111,66,255
1497,-428,1583,-373,255,111,66,255
1583,-373,1636,-256,255,111,66,255
1636,-256,1657,104,255,111,66,255
1657,104,1619,205,255,111,66,255
1619,205,1583,253,255,111,66,255
1583,253,1521,275,255,111,66,255
1521,275,1456,292,255,111,66,255
1456,292,1337,294,255,111,66,255
1337,294,1264,269,255,111,66,255
1264,269,1225,198,255,111,66,255
1225,198,1183,124,255,111,66,255
1183,124,1144,68,255,111,66,255
1144,68,1085,40,255,111,66,255
1085,40,999,45,255,111,66,255
999,45,946,76,255,111,66,255
946,76,924,125,255,111,66,255
924,125,898,185,255,111,66,255
898,185,889,250,255,111,66,255
889,250,878,311,255,111,66,255
878,311,881,479,255,111,66,255
881,479,752,481,255,111,66,255
752,481,751,474,255,111,66,255
